abbing - bata - child
afak - banig - mat
afuy - apoy - fire
al - atay - liver
a-ma - ama - father (stress on first a)
amfut - bawang - garlic
aranni - malapit - near
aritus - hikaw - earring 
atap - bubong - roof
atawa (tafalay) - asawa - spouse
atu - aso - dog
bakulud - bundok - mountain
bangog - amoy - smell
bannig - multo - ghost
balay - bahay - house
bafay - babae - woman
baffuy - baboy - pig
batu - bato - stone
bawu - bago - new
begget - iyakin - crybaby
bifig - labi - lips
bilat - karayom - needle
bilattungaw - 
bitun - bituin - star
bullaw - leeg - neck
buok - buhok - hair
camat - lata - can
cucu - kuku - nails
cuyung - tiyan - stomach
da (ada) - dugo - blood
dagâ - hintay - wait
dagabbul - hintay - wait
dalan - path(way)
dallun - amuyin - to sniff/smell
danum - tubig - water
dapping - soiled cloth (e.g. Nadapping ko)
darawi - kaliwa - left
dila - dila - tongue
diwanan - kanan - right
don (adon) - dahon - leaf
dumatang - dumating - to come
falagopog - mayabang - boastful
futu - puso - heart
gaddang - balat - skin
gafi - gabi - night
gamot - ugat - roots
garilatan - gupitin - to cut
gatod - ? - feather
girafuk - alikabok - dust
gumafu - dahil sa iyo - because of you
ikka - ikaw - you
ikkanak - ako - I
ikkanetam - tayo - we
ilog - itlog - egg
i-na - ina - mother (stress on i)
inanawan - iniwan - abandoned
itan - makita - to see
itappol - itapon - to throw
iyong - ilong - nose
kamat - kamay - hand
kangam - gusto - to like
kasiban - kumagat - to bite
kayo - puno - tree
kayo - kahoy - wood
korilaw (koriraw) - isda - fish
kutu - kuto - louse
lalaki - lalaki - man
lappaw - bulaklak - flower
layag - tenga - ear
lennat - roast
likud - likod - back
lufid - lubig - rope
maamuan - malaman - to know
mabambal - to wash clothes
mabuya - manood - to watch
macatucap - inaantok - sleepy
madacot - marumi - dirty
madadac - magdikdik - to pound/beat
madanag - mahulog - to fall
madet - itahi - to sew
madiat - kawawa - poor
madingag - madinig - to hear
magatang - bumili - to buy
makatawa - tumawa - to laugh
makokot - magnakaw - to steal
makkayyab - lumipad - to fly
makurakut - kamutin - to scratch
malangi - tumingin - to look (at something)
malaow - masakit - painful
malutu - magluto - to cook
maluppa - dumura - to spit
mallakad - lumakad - to walk
malliku - lumiko - to turn
mamáma - ngumuya - to chew
mammit - masarap - delicious
mammula - magtanim - to plant
manalog - lumangoy - to swim
mangan - kumain - to eat
mangat - huminga - to breathe
mannonot - magisip - to think
mangural - dull, blunt
mapili - pumili - to choose
mappet - mapait - bitter
mappia - ? - better
masapit - makasalita - to speak
masinnaw - maghugas (ng plato) - to wash (plates)
màta - matâ - eye
mataddag - tumayo - to stand
matalaw - matakot - to fear
matalofu - tumubo - to grow
matatenap - ? - to dream
matakaw - humiram - to borrow
mataram - matalim - sharp
matrabafu - magtrabaho - to work
mattangit - umiyak - to cry
maturog - matulog - to sleep
matuttud - umupo - to sit
minum - uminom - to drink
mula - halaman - plant
muli - bumalik - to go back
mumul - magsuso - to suck
muta - sumuka - to vomit
nabatug - nabusog - to be full
nagamya - nagising - woke up
nakam - akin - mine
nasiwarac - kumalat - scattered
natay - namatay - to die/be dead
netambam - pangako - promise
ngan - pangalan - name
ngipan - ngipin - teeth
pallaw - baliw - crazy
papitut - ibon - bird
patayan - patayin - to kill
payyak - pakpak - wing
raddam - lumbay/sakit - sorrow/pain
rangat - kulangot - booger
saccalang - singsing - ring 
sangi - bibig - mouth
sensewal - baduy - tacky
sigut - itali - to tie up/fasten
sinay - bituka - intestines
sinay - doon - there
sinoy - noon - before (as in "long time ago")
sisina - mamaya - later
susu - suso - breast
tafa - taba - fat/grease
takki - paa - foot
taggang - dibdib - chest/bosom
taggat - tigas - hard
tantam - tikman - to taste
tarulok - kabuti - mushroom
tigaman - hawakan - to hold
tolay - tao - person
tulang - buto - bone (* contextually may refer to force e.g. "Ikuanan no si tulang!" (Add some force!))
umang - pumunta - to go
uriel - vomited milk
wadawang - wide open
wangit - bunganga - mouth

tata - isa - one
adwa - dalawa - two
tallo - tatlo - three
